Name:test
Width:11
Height:5
Layer_tile:
WWWWWWWWWWW
W.........W
W.........W
W.........W
W.........W
WWWWWWWWWWW
Layer_items:
-----------
--+++++++--
-++++X++++-
--+++++++--
-----------
Layer_actors:
-----------
-1-------2-
-----------
-P-------3-
-----------