Name:"Hello small dot"
ID:2
Width:11
Height:11
Layer_tiles:
..WWW......
..W-WW.....
..W--WW....
..W---WW...
WWW----WWWW
W---------W
WWW----WWWW
..W---WW...
..W--WW....
..W-WW.....
..WWW......
Layer_items:
...........
...........
...........
...........
...........
.......+...
...........
...........
...........
...........
...........
Layer_actors:
...........
...........
...........
...........
...........
....1....P.
...........
...........
...........
...........
...........
