Name:"Hello prey"
ID:4
Width:11
Height:11
Layer_tiles:
...........
...........
...........
WWWWWWWWWWW
W---------W
WWW-WWWWWWW
W---------W
WWWWWWWWWWW
...........
...........
...........
Layer_items:
...........
...........
...........
...........
.......X...
...........
...........
...........
...........
...........
...........
Layer_actors:
...........
...........
...........
...........
.........P.
...........
.........1.
...........
...........
...........
...........
