Name:"testing"
ID:4
Width:11
Height:11
Layer_tiles:
...........
...........
...........
.WWWWWWWWW.
.W-------W.
.WW-WWWWWW.
.W-------W.
.WWWWWWWWW.
...........
...........
...........
Layer_items:
...........
...........
...........
...........
.......X...
...........
...........
...........
...........
...........
...........
Layer_actors:
...........
...........
...........
...........
........P..
...........
........1..
...........
...........
...........
...........
