Name:"testing"
ID:5
Width:11
Height:11
Layer_tiles:
WWWWWWWWWWW
W---W-W---W
W-W-W-W-W-W
W-W-----W-W
W-WWW-WWW-W
W---------W
W-WWW-WWW-W
W-W-----W-W
W-W-W-W-W-W
W---W-W---W
WWWWWWWWWWW
Layer_items:
...........
.X++...++X.
.+.+...+.+.
.+.+++++.+.
.+...+...+.
.++++.++++.
.+...+...+.
.+.+++++.+.
.+.+...+.+.
.X++...++X.
...........
Layer_actors:
...........
.....2.....
...........
...........
...........
.....P.....
...........
...........
...........
.....1.....
...........
