name:"race", width:11, height:11 {
        - - - - - - - - - - -
        - - - - - - - - - - -
        - - - - - - - - - - -
        - w w w w w - - - - -
        - w . . . w w w w w -
        - w . 1 . + . . P w -
        - w . . . w w w w w -
        - w w w w w - - - - -
        - - - - - - - - - - -
        - - - - - - - - - - -
        - - - - - - - - - - -
}