Name:Testing2
Width:11
Height:11
Layer_tiles:
...........
...........
...........
.WWWWW.....
.W---WWWWW.
.W-------W.
.W---WWWWW.
.WWWWW.....
...........
...........
...........
Layer_items:
...........
...........
...........
...........
...........
.....+.....
...........
...........
...........
...........
...........
Layer_actors:
...........
...........
...........
...........
...21......
...1....P..
....3......
...........
...........
...........
...........
