name:"massacre", width:11, height:11 {
    4 2 3 2 3 4 1 1 2 1 4
    4 1 4 1 3 2 3 1 4 2 3
    4 3 3 2 3 4 1 1 2 1 4
    1 4 2 3 2 . 4 2 1 2 4
    2 1 2 4 . X . 2 4 3 1
    1 1 3 . X P X . 4 4 2
    4 2 4 3 . X . 2 3 1 2
    4 1 3 1 4 . 1 1 2 1 4
    4 3 4 1 3 1 2 3 2 1 4
    2 1 3 3 2 4 2 1 4 2 1
    4 1 2 1 4 1 1 3 2 1 4
}